11111111111
S0001000001
11101011101
10001010001
10111010111
10100010001
10101010101
10101010101
10101010101
1000101010F
11111111111