111111111111111111111
S0001000100010001000F
101010101110101011101
101000100000001010001
101111111111111110101
100000000010000010101
111111111010111010101
100010100010001000101
101010101111111111101
101000100010000000101
101111111010111110101
101000001010000010001
101011101011111011101
100010000010001010101
111110111010101010101
100010101010101010001
101010101010111010111
101010001010000010001
101111111011111111101
100000000000000000001
111111111111111111111